French - Paul Noble

Date: 28-Sep-2025

I have = j'ai (jay with sh sound)
visited = visité (vi-si-tay)
I have visited = j'ai visité
the Louvre = le Louvre (looh Louvre)
I have visited the Louvre = j'ai visité le Louvre
the park = le parc
I have visited the park = j'ai visité le parc
You have = vous avez (woo-zah-way)
You have visited = vous avez visité
You have visited the Louvre = vous avez visité le Louvre
Have you = avez-vous (aa-way-vou)
Have you visited the park = avez-vous visité le parc (aa-way-vou visi-tay looh parc)
Have you visited the Louvre = avez-vous visité le Louvre (aa-way-vou visi-tay looh Louvre)
prepared = préparé (pre-PAH-ray)
I have prepared = j'ai préparé (jay pre-PAH-ray)
the coffee = le café (looh café)
I have prepared the coffee = j'ai préparé le café (jay pre-PAH-ray looh café)
for you = pour vous (pour woo)
I have prepared the coffee for you = j'ai préparé le café pour vous (jay pre-PAH-ray looh café pour woo)
the roast beef = le rosbif (looh rosbif)
I have prepared the roast beef = j'ai préparé le rosbif (jay pre-PAH-ray looh rosbif)
for dinner = pour le dîner (pour looh din-ay)
I have prepared the roast beef for dinner = j'ai préparé le rosbif pour le dîner [the le is pronounced as looh]
You have prepared the coffee = vous avez préparé le café (vou-za-way pre-PAH-ray looh café)
for me = pour moi
You have prepared the coffee for me = vous avez préparé le café pour moi (vou-za-way pre-PAH-ray loo café pour muaa)
Have you prepared the coffee for me ? = avez-vous préparé le café pour moi ? (aa-way-vou pre-PAH-ray looh café pour muaa ?)
I have prepared roast beef for dinner. Have you prepared the coffee? = j'ai préparé le rosbif pour le dîner. Avez-vous préparé le café ? (jay pre-PAH-ray looh rosbif pour looh din-ay. aa-way-vou pre-PAH-ray looh café ?)
He has = il a (eel ah)
He has prepared the coffee for me = il a préparé le café pour moi (eel ah pre-PAH-ray looh café pour moi)
She has = elle a (el-ah)
She has prepared the coffee for me = elle a préparé le café pour moi (el-ah pre-PAH-ray looh café pour moi)
Your = votre (voh-thruh)
Your coffee = votre café (voh-thruh looh café)
mother = mère (mare)
Your mother = votre mère (voh-thruh mare)
Your mother has prepared the coffee = votre mère a préparé le café (voh-thruh mare ah pre-PAH-ray looh café)
Your mother has = votre mère a (voh-thruh mare ah)
Your mother has visited the park = votre mère a visité le parc (voh-thruh mare ah visi-tay looh parc)
Your father = votre père (voh-thruh pair)
Your father has prepared the roast beef for dinner = votre père a préparé le rosbif pour le dîner (voh-thruh pair ah pre-PAH-ray looh rosbif pour looh din-ay)
Your father has = votre père a (voh-thruh pair ah)
Your mother has visited the park, your father has visited the Louvre = votre mère a visité le parc, votre père a visité le Louvre (voh-thruh mare ah visi-tay looh parc, voh-thruh pair ah visi-tay looh Louvre)
Preparation = préparation (pre-PAH-ray-syon)
Reservation = réservation (ray-zay-vas-syon)
Decoration = décoration (day-ko-ra-syon)
Invitation = invitation (anh-vi-tas-syon)
The house = la maison (lah may-zon)
I have decorated the house = j'ai décore la maison (jay day-ko-ray lah may-zon)
I decorated the house = j'ai décore la maison (jay day-ko-ray lah may-zon)
I did decorate the house = j'ai décore la maison (jay day-ko-ray lah may-zon)
You have decorated the house = vous avez décore la maison (vou-za-way day-ko-ray lah may-zon)
Have you decorated the house ? = avez-vous décore la maison ? (aa-way-vou day-ko-ray lah may-zon ?)
He has reserved = il a réservé (eel ah ray-zer-vay)
a table = une table (oon tah-bla)
He has reserved a table = il a réservé une table (eel ah ray-zer-vay oon tah-bla)
He reserved a table = il a réservé une table (eel ah ray-zer-vay oon tah-bla)
He did reserve a table = il a réservé une table (eel ah ray-zer-vay oon tah-bla)
She has reserved = elle a réservé (el-ah ray-zer-vay)
She has reserved a table = elle a réservé une table (el-ah ray-zer-vay oon tah-bla)
Your father has reserved a table = votre père a réservé une table (voh-thruh pair ah ray-zer-vay oon tah-bla)

Date: 29-Sep-2025
I have reserved a table for you = j'ai réservé une table pour vous (jay ray-zer-vay oon tah-bla pour woo)
I have reserved a table for dinner = j'ai réservé une table pour le dîner (jay ray-zer-vay oon tah-bla pour looh din-ay)
invited = invité (ahn-vit-tey)
I have invited = j'ai invité (jay ahn-vit-tey)
I have invited Paul = j'ai invité Paul (jay ahn-vit-tey Paul)
to the park = au parc (oh paark)
I have invited Paul to the park = j'ai invité Paul au parc (jay ahn-vit-tey Paul oh paark)
to the cinema = au cinéma (oh see-ney-maa)
Have you invited Paul to the cinema ? = avez-vous invité Paul au cinéma ? (aa-way-vou ahn-vit-tey Paul oh see-ney-maa ?)
to prepare = à préparer (ah pre-PAH-ray)
I have invited Paul to prepare the coffee = j'ai invité Paul à préparer le café (jay ahn-vit-tey Paul ah pre-PAH-ray looh café)
I would like = je voudrais (juh voo-dray)
I would like to prepare = je voudrais préparer (juh voo-dray pre-PAH-ray)
I would like to prepare the dinner = je voudrais préparer le dîner (juh voo-dray pre-PAH-ray looh din-ay)
I would like Paul to prepare the coffee = je voudrais que Paul prépare le café (juh voo-dray queue Paul pre-PAH-ray looh café) [que = that]
to dine = à dîner (ah din-ay)
hunger = faim (fanh - n is nasal)
I am hungry = je suis faim (juh soo fanh)
I have hunger = j'ai faim (jay fanh)
because = parce que (parse-kuh)
I would like to prepare the dinner because I am hungry = je voudrais préparer le dîner parce que j'ai faim (juh voo-dray pre-PAH-ray looh din-ay parse-kuh jay fanh)
I would like to prepare the coffee = je voudrais préparer le café (juh voo-dray pre-PAH-ray looh café)
thirst = soif (swaf)
I am thirsty = je suis soif (juh soo swaf)
I have thirst = j'ai soif (jay swaf)
because I am thirsty = parce que je suis soif (parse-kuh juh soo swaf)
I would like to prepare the coffee because I am thirsty = je voudrais préparer le café parce que j'ai soif (juh voo-dray pre-PAH-ray looh café parse-kuh jay swaf)