29-Sep-2025
============
Lesson 01.
I can = ich kann (eesh kahn)
I can speak = ich kann sprechen (eesh kahn spre-khen)
begin = beginnen (begin-nen)
bring = bringen (bring-en)
not = nicht (nisht)
I cannot = ich kann nicht (eesh kahn nisht)
I cannot camp = ich kann nicht campen (eesh kahn nisht camp-en)
I cannot speak = ich kann nicht sprechen (eesh kahn nisht spre-khen)
I cannot begin = ich kann nicht beginnen (eesh kahn nisht begin-nen)
I cannot bring = ich kann nicht bringen (eesh kahn nisht bring-en)
park = parken (park-en)
I can park = ich kann parken (eesh kahn park-en)
I cannot park = ich kann nicht parken (eesh kahn nisht park-en)
She can = sie kann (zee kahn)
She can begin = sie kann beginnen (zee kahn begin-nen)
She can camp = sie kann campen (zee kahn camp-en)
She cannot camp = sie kann nicht campen (zee kahn nisht camp-en)
She cannot park = sie kann nicht parken (zee kahn nisht park-en)
come = kommen (kho-men)
She can come = sie kann kommen (zee kahn kho-men)
She cannot come = sie kann nicht kommen (zee kahn nisht kho-men)
I cannot come = ich kann nicht kommen (eesh kahn nisht kho-men)
but = aber (aa-baa)
but I cannot come = aber ich kann nicht kommen (aa-baa eesh kahn nisht kho-men)

Lesson 02.
She can camp but I cannot come = sie kann campen aber ich kann nicht kommen (zee kahn camp-en aa-baa eesh kahn nisht kho-men)
I can come = ich kann kommen (eesh kahn kho-men)
I can come but I cannot park = ich kann kommen aber ich kann nicht parken (eesh kahn kho-men aa-baa eesh kahn nisht park-en)
I would like = ich möchte (eesh mo-sh-tu)
to begin = beginnen (begin-nen)
I would like to begin = ich möchte beginnen (eesh mo-sh-tu begin-nen)
I would not like to begin = ich möchte nicht beginnen (eesh mo-sh-tu nisht begin-nen)
She would like = sie möchte (zee mo-sh-tu)
She would like to begin = sie möchte beginnen (zee mo-sh-tu begin-nen)
She would not like to begin = sie möchte nicht beginnen (zee mo-sh-tu nisht begin-nen)
to camp = campen (camp-en)
she would like to camp = sie möchte campen (zee mo-sh-tu camp-en)
to come = kommen (kho-men)
I would like to come = ich möchte kommen (eesh mo-sh-tu kho-men)
She would like to come = sie möchte kommen (zee mo-sh-tu kho-men)
to park = parken (park-en)
I would like to park = ich möchte parken (eesh mo-sh-tu park-en)
She would not like to park = sie möchte nicht parken (zee mo-sh-tu nisht park-en)
to park here = hier parken (hee-er park-en)
I would like to park here = ich möchte hier parken (eesh mo-sh-tu hee-er park-en)
She would like to park here = sie möchte hier parken (zee mo-sh-tu hee-er park-en)
can I = kann ich (kahn eesh)
can I park here ? = kann ich hier parken (kahn eesh hee-er park-en)
I would like to park here, can I ? = ich möchte hier parken, kann ich ? (eesh mo-sh-tu hee-er park-en kahn eesh)
can she park here ? = kann sie hier parken ? (kahn zee hee-er park-en)
to camp here = hier campen (hee-er camp-en)
can she camp here ? = kann sie hier campen ? (kahn zee hee-er camp-en)
can I camp here ? = kann ich hier campen ? (kahn eesh hee-er camp-en)
I would like to camp here = ich möchte hier campen (eesh mo-sh-tu hee-er camp-en)
she would like to camp here = sie möchte hier campen (zee mo-sh-tu hee-er camp-en)
she cannot come = sie kann nicht kommen (zee kahn nisht kho-men)
but she can't come = aber sie kann nicht kommen (aa-baa zee kahn nisht kho-men)
she would like to camp here but she can't come = sie möchte hier campen aber sie kann nicht kommen (zee mo-sh-tu hee-er camp-en aa-baa zee kahn nisht kho-men)
I would like to camp here but I cannot come = ich möchte hier campen aber ich kann nicht kommen (eesh mo-sh-tu hee-er camp-en aa-baa eesh kahn nisht kho-men)
to begin here = hier beginnen (hee-er begin-nen)
I would like to begin here = ich möchte hier beginnen (eesh mo-sh-tu hee-er begin-nen)
she would like to begin here = sie möchte hier beginnen (zee mo-sh-tu hee-er begin-nen)
can she begin here ? = kann sie hier beginnen ? (kahn zee hee-er begin-nen)
can I begin here? = kann ich hier beginnen ? (kahn eesh hee-er begin-nen)
drink = trinken (thrink-en)
I can drink = ich kann trinken (eesh kahn thrink-en)
can I drink ? = kann ich trinken ? (kahn eesh thrink-en)
to drink here = hier trinken (hee-er thrink-en)
can I drink here ? = kann ich hier trinken ? (kahn eesh hee-er thrink-en)
I would like to drink here = ich möchte hier trinken (eesh mo-sh-tu hee-er thrink-en)
I would like to drink here, can I ? = ich möchte hier trinken, kann ich ? (eesh mo-sh-tu hee-er thrink-en kahn eesh)
she would not like to drink here = sie möchte nicht hier trinken (zee mo-sh-tu nisht hee-er thrink-en)
dance = tanzen (tanzen)
I can dance = ich kann tanzen (eesh kahn tanzen)
I would like to dance = ich möchte tanzen (eesh mo-sh-tu tanzen)
She can dance = sie kann tanzen (zee kahn tanzen)
She would like to dance = sie möchte tanzen (zee mo-sh-tu tanzen)
She would not like to dance = sie möchte nicht tanzen (zee mo-sh-tu nisht tanzen)
to dance here = hier tanzen (hee-er tanzen)
I would like to dance here = ich möchte hier tanzen (eesh mo-sh-tu hee-er tanzen)
She would not like to dance here = sie möchte nicht hier tanzen (zee mo-sh-tu nisht hee-er tanzen)